10000000600000000000000000000
00000000000000000000000000000
00000000000000000000000000000
00000000000000000000009999999
00000000000000000000600000002